......... ......... ......... ......... .........
......... ...ooo... ...ooo... ...ooo... .........
......... ...ooo... ...ooo... ...o..... .........
......... ...ooo... ...ooo... ...ooo... .........
......... ......... ......... ......... .........
......... ......... ......... ......... .........
......... ......... ......... ......... .........
......... ......... ......... ......... .........
......... ......... ......... ......... .........

......... ......... ......... ......... .........
......... ...ooo... ...ooo... ...ooo... .........
......... ...ooo... ...oXo... ...o.o... .........
......... ...ooo... ...ooo... ...ooo... .........
......... ......... ......... ......... .........
......... ......... ......... ......... .........
......... ......... ....#.... ......... .........
......... ......... ....@.... ......... .........
......... ......... ......... ......... .........

......... ......... ......... ......... .........
......... ...ooo... ...ooo... ...ooo... .........
......... ...ooo... ...ooo... ...ooo... .........
......... ...ooo... ...ooo... ...ooo... .........
......... ......... ......... ......... .........
......... ......... ......... ......... .........
......... ......... ......... ......... .........
......... ......... ......... ......... .........
......... ......... ......... ......... .........
