.........
.........
.........
.........
.........
.........
.........

.........
...ooo...
...ooo...
...ooo...
.........
.........
.........

.........
...ooo...
...oXo...
...ooo...
.........
....#....
....@....

.........
...ooo...
...o.....
...ooo...
.........
.........
.........

.........
.........
.........
.........
.........
.........
.........
