......... ......... .........
......... ......... .........
......... ......... .........
......... ......... .........
....X.... ......... .........
......... ......... .........
......... ......... .........
......... ......... .........
......... ......... .........

......... ......... .........
......... ......... .........
......... ......... .........
......... ......... .........
......... ....#.... .........
......... ......... .........
......... ......... .........
......... ......... .........
......... ......... .........

......... ......... .........
......... ......... .........
......... ......... .........
......... ......... .........
......... ......... ....@....
......... ......... .........
......... ......... .........
......... ......... .........
......... ......... .........
