... ... ...
... ... ...
... ... ...

... .X. ...
... .#. ...
... .@. ...

... ... ...
... ... ...
... ... ...
